...▒▒▒▒▒▒▒▒▒▒▒▒▒▒▒▒▒▒▒▒▒▒▒▒▒▒▒▒▒▒▒▒▒▒▒▒▒▒▒▒▒▒▒▒▒▒▒▒▒▒▒▒▒▒▒▒▒▒▒▒▒▒▒▒▒▒▒▒▒▒▒▒▒
......▒.....▒...........▒..▒..▒..▒.....▒........▒.....▒.....▒..▒.....▒.....▒
▒..▒..▒▒▒▒..▒..▒▒▒▒▒▒▒..▒..▒..▒..▒..▒..▒▒▒▒..▒▒▒▒..▒..▒..▒..▒..▒..▒▒▒▒..▒..▒
▒..▒...........▒..▒.................▒..▒........▒..▒.....▒..............▒..▒
▒..▒▒▒▒▒▒▒▒▒▒▒▒▒..▒▒▒▒▒▒▒▒▒▒..▒▒▒▒..▒▒▒▒▒▒▒▒▒▒..▒▒▒▒..▒..▒▒▒▒▒▒▒▒▒▒..▒▒▒▒▒▒▒
▒.....▒..............▒.....▒..▒..▒..▒.....▒...........▒..▒..............▒..▒
▒..▒..▒.╬▒..▒▒▒▒▒▒▒..▒▒▒▒..▒..▒..▒▒▒▒..▒▒▒▒▒▒▒..▒▒▒▒▒▒▒..▒▒▒▒▒▒▒▒▒▒▒▒▒▒▒▒..▒
▒..▒.....▒..▒.....▒..▒....................▒..▒..▒..............▒...........▒
▒.╬▒▒▒▒▒▒▒▒▒▒▒▒▒..▒..▒▒▒▒▒▒▒▒▒▒▒▒▒▒▒▒..▒▒▒▒..▒▒▒▒..▒▒▒▒▒▒▒▒▒▒▒▒▒▒▒▒▒▒▒▒▒▒..▒
▒..............▒...........▒....................▒.......................▒..▒
▒..▒▒▒▒..▒▒▒▒..▒▒▒▒▒▒▒..▒▒▒▒▒▒▒..▒▒▒▒..▒▒▒▒▒▒▒..▒▒▒▒▒▒▒..▒▒▒▒▒▒▒▒▒▒..▒..▒..▒
▒..▒........▒..▒...........▒.....▒..▒.....▒.....▒..▒..▒..▒........▒..▒.....▒
▒▒▒▒▒▒▒▒▒▒▒▒▒▒▒▒..▒..▒▒▒▒▒▒▒..▒▒▒▒..▒▒▒▒..▒▒▒▒▒▒▒..▒..▒..▒▒▒▒..▒▒▒▒..▒..▒▒▒▒
▒.....▒........▒..▒.....▒........▒..▒..▒.....▒........▒........▒..▒..▒.....▒
▒..▒▒▒▒▒▒▒..▒▒▒▒▒▒▒..▒▒▒▒..▒▒▒▒▒▒▒..▒..▒..▒..▒▒▒▒▒▒▒..▒..▒▒▒▒..▒..▒▒▒▒..▒..▒
▒..▒........▒........▒..▒..▒..............▒...........▒.....▒..▒..▒.....▒..▒
▒..▒..▒▒▒▒▒▒▒▒▒▒..▒..▒..▒..▒▒▒▒..▒..▒..▒▒▒▒..▒..▒▒▒▒▒▒▒..▒..▒▒▒▒..▒..▒▒▒▒▒▒▒
▒.....▒.....▒.....▒..▒..▒..▒.....▒..▒.....▒..▒..▒..▒.....▒..▒........▒.....▒
▒▒▒▒..▒▒▒▒..▒▒▒▒..▒..▒..▒..▒▒▒▒▒▒▒▒▒▒▒▒▒..▒..▒▒▒▒..▒▒▒▒▒▒▒▒▒▒▒▒▒..▒..▒..▒▒▒▒
▒...........▒.....▒..▒.....▒..▒..▒........▒.................▒..▒..▒.....▒..▒
▒..▒▒▒▒..▒▒▒▒..▒▒▒▒▒▒▒▒▒▒..▒..▒..▒▒▒▒▒▒▒..▒▒▒▒▒▒▒..▒▒▒▒▒▒▒..▒..▒..▒▒▒▒▒▒▒..▒
▒..▒..▒.....▒........▒..............▒........▒..▒..▒...........▒.....▒.....▒
▒..▒..▒..▒▒▒▒▒▒▒..▒▒▒▒..▒..▒▒▒▒▒▒▒▒▒▒▒▒▒..▒..▒..▒..▒▒▒▒▒▒▒▒▒▒..▒..▒..▒..▒▒▒▒
▒..▒.................▒..▒..▒..............▒.....▒..▒.....▒........▒.....▒..▒
▒..▒▒▒▒▒▒▒▒▒▒▒▒▒▒▒▒..▒..▒..▒▒▒▒▒▒▒..▒▒▒▒▒▒▒..▒▒▒▒..▒▒▒▒..▒..▒▒▒▒▒▒▒▒▒▒▒▒▒..▒
▒..▒...........▒.....▒..▒.....▒........▒........▒..▒.....▒...........▒.....▒
▒..▒..▒▒▒▒..▒▒▒▒▒▒▒▒▒▒..▒..▒..▒▒▒▒..▒▒▒▒▒▒▒▒▒▒▒▒▒▒▒▒..▒▒▒▒▒▒▒▒▒▒..▒▒▒▒▒▒▒..▒
▒.....▒..▒.....▒..▒..▒..▒..▒.....▒....................▒..▒.....▒...........▒
▒..▒..▒..▒▒▒▒..▒..▒..▒▒▒▒..▒..▒▒▒▒▒▒▒..▒▒▒▒▒▒▒▒▒▒▒▒▒▒▒▒..▒..▒..▒..▒..▒▒▒▒..▒
▒..▒.....▒.....▒...........▒..▒...........▒.................▒.....▒X.▒.....▒
▒▒▒▒▒▒▒▒▒▒▒▒▒▒▒▒▒▒▒▒▒▒▒▒▒▒▒▒▒▒▒▒▒▒▒▒▒▒▒▒▒▒▒▒▒▒▒▒▒▒▒▒▒▒▒▒▒▒▒▒▒▒▒▒▒▒▒▒▒▒▒▒▒▒▒▒




























...▒▒▒▒▒▒▒▒▒▒▒▒▒▒▒▒▒▒▒▒▒▒▒▒▒▒▒▒▒▒▒▒▒▒▒▒▒▒▒▒▒▒▒▒▒▒▒▒▒▒▒▒▒▒▒▒▒▒▒▒▒▒▒▒▒▒▒▒▒▒▒▒▒
......▒.....▒╬..........▒..▒..▒..▒.....▒.╬......▒.....▒.....▒╬.▒.....▒.....▒
▒..▒..▒▒▒▒..▒..▒▒▒▒▒▒▒..▒..▒..▒..▒.╬▒..▒▒▒▒..▒▒▒▒..▒..▒..▒..▒..▒..▒▒▒▒..▒╬.▒
▒..▒...........▒..▒.................▒..▒........▒..▒.....▒..............▒..▒
▒..▒▒▒▒▒▒▒▒▒▒▒▒▒..▒▒▒▒▒▒▒▒▒▒..▒▒▒▒..▒▒▒▒▒▒▒▒▒▒╬.▒▒▒▒..▒..▒▒▒▒▒▒▒▒▒▒╬.▒▒▒▒▒▒▒
▒.....▒..............▒.....▒╬.▒..▒╬.▒.....▒...........▒╬.▒..............▒..▒
▒..▒..▒.╬▒..▒▒▒▒▒▒▒╬.▒▒▒▒..▒..▒..▒▒▒▒..▒▒▒▒▒▒▒..▒▒▒▒▒▒▒..▒▒▒▒▒▒▒▒▒▒▒▒▒▒▒▒..▒
▒..▒.....▒..▒.....▒..▒╬...................▒..▒..▒..............▒╬..........▒
▒.╬▒▒▒▒▒▒▒▒▒▒▒▒▒..▒..▒▒▒▒▒▒▒▒▒▒▒▒▒▒▒▒╬.▒▒▒▒..▒▒▒▒.╬▒▒▒▒▒▒▒▒▒▒▒▒▒▒▒▒▒▒▒▒▒▒.╬▒
▒..............▒...........▒....................▒.......................▒..▒
▒..▒▒▒▒..▒▒▒▒╬.▒▒▒▒▒▒▒..▒▒▒▒▒▒▒..▒▒▒▒..▒▒▒▒▒▒▒..▒▒▒▒▒▒▒..▒▒▒▒▒▒▒▒▒▒..▒..▒..▒
▒..▒........▒..▒╬..........▒╬....▒..▒....╬▒.....▒..▒..▒..▒........▒..▒.....▒
▒▒▒▒▒▒▒▒▒▒▒▒▒▒▒▒..▒..▒▒▒▒▒▒▒..▒▒▒▒..▒▒▒▒..▒▒▒▒▒▒▒..▒..▒..▒▒▒▒╬.▒▒▒▒..▒..▒▒▒▒
▒.....▒........▒..▒.....▒........▒..▒..▒.....▒........▒........▒..▒╬.▒.....▒
▒..▒▒▒▒▒▒▒..▒▒▒▒▒▒▒.╬▒▒▒▒╬.▒▒▒▒▒▒▒..▒..▒╬.▒..▒▒▒▒▒▒▒╬.▒..▒▒▒▒..▒..▒▒▒▒..▒.╬▒
▒..▒........▒........▒..▒..▒..............▒...........▒.....▒..▒..▒.....▒..▒
▒..▒╬.▒▒▒▒▒▒▒▒▒▒..▒..▒..▒..▒▒▒▒..▒..▒..▒▒▒▒..▒..▒▒▒▒▒▒▒..▒..▒▒▒▒..▒..▒▒▒▒▒▒▒
▒.....▒.....▒.....▒..▒..▒.╬▒.....▒..▒.....▒..▒..▒..▒╬....▒..▒........▒.....▒
▒▒▒▒..▒▒▒▒╬.▒▒▒▒..▒..▒..▒..▒▒▒▒▒▒▒▒▒▒▒▒▒..▒.╬▒▒▒▒..▒▒▒▒▒▒▒▒▒▒▒▒▒.╬▒..▒..▒▒▒▒
▒...........▒....╬▒..▒.....▒..▒..▒.......╬▒.................▒..▒..▒.....▒.╬▒
▒..▒▒▒▒..▒▒▒▒..▒▒▒▒▒▒▒▒▒▒..▒..▒╬.▒▒▒▒▒▒▒..▒▒▒▒▒▒▒..▒▒▒▒▒▒▒╬.▒..▒..▒▒▒▒▒▒▒..▒
▒..▒..▒.....▒........▒..............▒........▒..▒..▒...........▒.....▒╬....▒
▒..▒..▒╬.▒▒▒▒▒▒▒..▒▒▒▒╬.▒..▒▒▒▒▒▒▒▒▒▒▒▒▒╬.▒..▒..▒.╬▒▒▒▒▒▒▒▒▒▒..▒╬.▒..▒..▒▒▒▒
▒╬.▒.................▒..▒╬.▒..............▒.....▒..▒..╬..▒........▒.....▒..▒
▒..▒▒▒▒▒▒▒▒▒▒▒▒▒▒▒▒..▒..▒..▒▒▒▒▒▒▒╬.▒▒▒▒▒▒▒..▒▒▒▒..▒▒▒▒..▒..▒▒▒▒▒▒▒▒▒▒▒▒▒╬.▒
▒..▒...........▒╬....▒.╬▒.....▒........▒........▒..▒╬....▒...........▒.....▒
▒..▒..▒▒▒▒.╬▒▒▒▒▒▒▒▒▒▒..▒..▒..▒▒▒▒..▒▒▒▒▒▒▒▒▒▒▒▒▒▒▒▒..▒▒▒▒▒▒▒▒▒▒.╬▒▒▒▒▒▒▒..▒
▒.....▒..▒.....▒..▒..▒..▒..▒.....▒....................▒..▒.....▒..........╬▒
▒╬.▒..▒..▒▒▒▒..▒..▒.╬▒▒▒▒..▒..▒▒▒▒▒▒▒.╬▒▒▒▒▒▒▒▒▒▒▒▒▒▒▒▒..▒..▒..▒╬.▒╬.▒▒▒▒..▒
▒..▒.....▒.....▒...........▒..▒...........▒╬................▒.....▒X.▒.....▒
▒▒▒▒▒▒▒▒▒▒▒▒▒▒▒▒▒▒▒▒▒▒▒▒▒▒▒▒▒▒▒▒▒▒▒▒▒▒▒▒▒▒▒▒▒▒▒▒▒▒▒▒▒▒▒▒▒▒▒▒▒▒▒▒▒▒▒▒▒▒▒▒▒▒▒▒




|||||||||||||||
| | | | | | | |
|||||||||||||||
| | | | | | | |
|||||||||||||||
| | | | | | | |
|||||||||||||||
| | | | | | | |
|||||||||||||||
| | | | | | | |
|||||||||||||||
| | | | | | | |
|||||||||||||||
| | | | | | | |
|||||||||||||||